# BobbleBubble levels file
[LEVELS]
totallevels=5;

[LEVEL1]
tile=data/pattern1.bmp;
redshadow=240;
greenshadow=80;
blueshadow=220;
redbackclr=220;
greenbackclr=255;
bluebackclr=120;
pla1-row=25;
pla1-col=2;
pla2-row=25;
pla2-col=23;
row 0=11111111111111111111111111;
row 1=10000000000000000000000001;
row 2=10000000000000000000000001;
row 3=10000000000000000000000001;
row 4=10000000000000000000000001;
row 5=10000000000000000000000001;
row 6=10000000000000000000000001;
row 7=10000000000000000000000001;
row 8=10000000000000000000000001;
row 9=10000000000000000000000001;
row10=10000000020000002000000001;
row11=10000001000000000010000001;
row12=10000001111111111110000001;
row13=10000000000000000000000001;
row14=10000000000000000000000001;
row15=10000000000000000000000001;
row16=10000001111111111110000001;
row17=10000000000000000000000001;
row18=10000000000000000000000001;
row19=10000000000000000000000001;
row20=11000000000000000000000011;
row21=10000000000000000000000001;
row22=10000001111111111110000001;
row23=10000000000000000000000001;
row24=10000000000000000000000001;
row25=10000000000000000000000001;
row26=10000000000000000000000001;
row27=11111111111111111111111111;

[LEVEL2]
tile=data/pattern2.bmp;
redshadow=80;
greenshadow=80;
blueshadow=120;
redbackclr=195;
greenbackclr=195;
bluebackclr=200;
pla1-row=25;
pla1-col=2;
pla2-row=25;
pla2-col=23;
row 0=11111111111111111111111111;
row 1=10000000000000000000000001;
row 2=10000000000000000000000001;
row 3=10000000000000000000000001;
row 4=10000000000000000000000001;
row 5=10000000000000000000000001;
row 6=10000000000000000000000001;
row 7=10000000000000000000000001;
row 8=10000000000000000000000001;
row 9=10002000020000200002000001;
row10=10000000000000000000000001;
row11=10000000000000000000000001;
row12=10111111111111111111111101;
row13=10000000000000000000000001;
row14=10000000000000000000000001;
row15=10000111110000001111100001;
row16=10000000000000000000000001;
row17=10000000000000000000000001;
row18=10000011111000011111000001;
row19=10000000000000000000000001;
row20=10000000000000000000000001;
row21=10000001111100111110000001;
row22=10200000000000000000000201;
row23=10000000000000000000000001;
row24=11111100000000000000111111;
row25=10000000000000000000000001;
row26=10000100000000000000100001;
row27=11111111111111111111111111;

[LEVEL3]
tile=data/pattern3.bmp;
redshadow=240;
greenshadow=80;
blueshadow=220;
redbackclr=220;
greenbackclr=255;
bluebackclr=120;
pla1-row=25;
pla1-col=2;
pla2-row=25;
pla2-col=23;
row 0=11111111111111111111111111;
row 1=10000000000000000000000001;
row 2=10000000000000000000000001;
row 3=10000000000000000000000001;
row 4=10001111111111111111110001;
row 5=10001000000000000000010001;
row 6=10001000000000000000010001;
row 7=10001000000000200000010001;
row 8=10001000000010000100010001;
row 9=10001000000011111100010001;
row10=10001000000000000000010001;
row11=10001000000000000000010001;
row12=10001000000000000000010001;
row13=10001000000000000000010001;
row14=10001000000000000011110001;
row15=10001000020002000000010001;
row16=10001000000000000002010001;
row17=10001000000000000000010001;
row18=10001000000000000011110001;
row19=10001000000000000000010001;
row20=10001000000000000000010001;
row21=10001000000000000000010001;
row22=10001111111111111111110001;
row23=10000000000000000000000001;
row24=10000000110000001100000001;
row25=10000000000000000000000001;
row26=10000000000000000000000001;
row27=11111111111111111111111111;

[LEVEL4]
tile=data/pattern4.bmp;
redshadow=80;
greenshadow=100;
blueshadow=90;
redbackclr=200;
greenbackclr=255;
bluebackclr=190;
pla1-row=25;
pla1-col=2;
pla2-row=25;
pla2-col=23;
row 0=11111111111111111111111111;
row 1=10000000000000000000000001;
row 2=10000000000000000000000001;
row 3=10000020002000020002000001;
row 4=10001000000000000000010001;
row 5=10001111111111111111110001;
row 6=10000000000000000000000001;
row 7=10000000000000000000000001;
row 8=10000000000000000000000001;
row 9=10000000000000000000000001;
row10=10000000000000000000000001;
row11=10000000000000000000000001;
row12=10000000000000000000000001;
row13=10000000000000000000000001;
row14=10000000000000000000000001;
row15=10000000000000000000000001;
row16=10000000000000000000000001;
row17=10000000000000000000000001;
row18=10000000000000000000000001;
row19=10011111111111111111111001;
row20=10000000000000000000000001;
row21=10000000000200200000000001;
row22=10010010000000000001001001;
row23=10011111111111111111111001;
row24=10000000000000000000000001;
row25=10000000000000000000000001;
row26=10001000000000000000010001;
row27=11111111111111111111111111;

[LEVEL5]
tile=data/pattern5.bmp;
redshadow=160;
greenshadow=160;
blueshadow=120;
redbackclr=210;
greenbackclr=210;
bluebackclr=180;
pla1-row=25;
pla1-col=2;
pla2-row=25;
pla2-col=23;
row 0=11111111111111111111111111;
row 1=10000000000000000000000001;
row 2=10200000000000000000002001;
row 3=10000000000000000000000001;
row 4=10000000000000000000000001;
row 5=10000000020000002000000001;
row 6=10000010000000000001000001;
row 7=10000011111111111111000001;
row 8=10000010002000020001000001;
row 9=10000010000000000001000001;
row10=10000011111111111111000001;
row11=10000010000000000001000001;
row12=10000010000000000001000001;
row13=10000011111111111111000001;
row14=10000010000002000001000001;
row15=10000010000000000001000001;
row16=10000011111111111111000001;
row17=10000010002000000001000001;
row18=10000010000000000001000001;
row19=10000011111111111111000001;
row20=10000010000000000001000001;
row21=10000010000000000001000001;
row22=10000011111111111111000001;
row23=10000000000000000000000001;
row24=10000000000000000000000001;
row25=10000000000000000000000001;
row26=10001000000000000000010001;
row27=11111111111111111111111111;

; Level layout
[LEVELX]
tile=data/pattern1.bmp;
redshadow=240;
greenshadow=80;
blueshadow=220;
redbackclr=220;
greenbackclr=255;
bluebackclr=120;
pla1-row=25;
pla1-col=2;
pla2-row=25;
pla2-col=23;
row 0=11111111111111111111111111;
row 1=10000000000000000000000001;
row 2=10000000000000000000000001;
row 3=10000000000000000000000001;
row 4=10000000000000000000000001;
row 5=10000000000000000000000001;
row 6=10000000000000000000000001;
row 7=10000000000000000000000001;
row 8=10000000000000000000000001;
row 9=10000000000000000000000001;
row10=10000000000000000000000001;
row11=10000000000000000000000001;
row12=10000000000000000000000001;
row13=10000000000000000000000001;
row14=10000000000000000000000001;
row15=10000000000000000000000001;
row16=10000000000000000000000001;
row17=10000000000000000000000001;
row18=10000000000000000000000001;
row19=10000000000000000000000001;
row20=10000000000000000000000001;
row21=10000000000000000000000001;
row22=10000000000000000000000001;
row23=10000000000000000000000001;
row24=10000000000000000000000001;
row25=10000000000000000000000001;
row26=10000000000000000000000001;
row27=11111111111111111111111111;
